12
1,7,6,3,7,5,5,7,5,5,5,6
3,14,10,9,13,5,5,13,5,5,6,10
10,10,9,5,5,5,5,5,5,6,10,10
10,9,5,5,5,5,5,5,6,10,10,10
11,5,5,5,7,5,5,7,15,15,14,10
11,5,5,6,10,3,6,10,10,10,10,10
11,5,6,10,10,9,14,10,10,10,10,10
11,6,10,10,9,7,15,12,10,10,10,10
11,14,10,9,5,13,13,5,13,13,14,10
10,10,9,5,5,7,5,5,5,5,13,14
10,9,7,5,5,13,5,5,5,5,5,14
9,5,13,5,5,5,5,5,5,5,5,12